,Unnamed: 0,areaType,areaName,areaCode,date,newCasesBySpecimenDate,cumCasesBySpecimenDate,newFirstEpisodesBySpecimenDate,cumFirstEpisodesBySpecimenDate
0,840,overview,United Kingdom,K02000001,2020/1/30,1,1,1,1
1,839,overview,United Kingdom,K02000001,2020/1/31,0,1,0,1
2,838,overview,United Kingdom,K02000001,2020/2/1,0,1,0,1
3,837,overview,United Kingdom,K02000001,2020/2/2,1,2,1,2
4,836,overview,United Kingdom,K02000001,2020/2/3,19,21,19,21
5,835,overview,United Kingdom,K02000001,2020/2/4,0,21,0,21
6,834,overview,United Kingdom,K02000001,2020/2/5,1,22,1,22
7,833,overview,United Kingdom,K02000001,2020/2/6,0,22,0,22
8,832,overview,United Kingdom,K02000001,2020/2/7,0,22,0,22
9,831,overview,United Kingdom,K02000001,2020/2/8,3,25,3,25
10,830,overview,United Kingdom,K02000001,2020/2/9,1,26,1,26
11,829,overview,United Kingdom,K02000001,2020/2/10,1,27,1,27
12,828,overview,United Kingdom,K02000001,2020/2/11,4,31,4,31
13,827,overview,United Kingdom,K02000001,2020/2/12,1,32,1,32
14,826,overview,United Kingdom,K02000001,2020/2/13,1,33,1,33
15,825,overview,United Kingdom,K02000001,2020/2/14,0,33,0,33
16,824,overview,United Kingdom,K02000001,2020/2/15,0,33,0,33
17,823,overview,United Kingdom,K02000001,2020/2/16,0,33,0,33
18,822,overview,United Kingdom,K02000001,2020/2/17,1,34,1,34
19,821,overview,United Kingdom,K02000001,2020/2/18,0,34,0,34
20,820,overview,United Kingdom,K02000001,2020/2/19,0,34,0,34
21,819,overview,United Kingdom,K02000001,2020/2/20,0,34,0,34
22,818,overview,United Kingdom,K02000001,2020/2/21,2,36,2,36
23,817,overview,United Kingdom,K02000001,2020/2/22,0,36,0,36
24,816,overview,United Kingdom,K02000001,2020/2/23,6,42,6,42
25,815,overview,United Kingdom,K02000001,2020/2/24,2,44,2,44
26,814,overview,United Kingdom,K02000001,2020/2/25,3,47,3,47
27,813,overview,United Kingdom,K02000001,2020/2/26,2,49,2,49
28,812,overview,United Kingdom,K02000001,2020/2/27,8,57,8,57
29,811,overview,United Kingdom,K02000001,2020/2/28,12,69,12,69
30,810,overview,United Kingdom,K02000001,2020/2/29,4,73,4,73
31,809,overview,United Kingdom,K02000001,2020/3/1,20,93,20,93
32,808,overview,United Kingdom,K02000001,2020/3/2,41,134,41,134
33,807,overview,United Kingdom,K02000001,2020/3/3,57,191,57,191
34,806,overview,United Kingdom,K02000001,2020/3/4,56,247,56,247
35,805,overview,United Kingdom,K02000001,2020/3/5,49,296,49,296
36,804,overview,United Kingdom,K02000001,2020/3/6,83,379,83,379
37,803,overview,United Kingdom,K02000001,2020/3/7,68,447,68,447
38,802,overview,United Kingdom,K02000001,2020/3/8,55,502,55,502
39,801,overview,United Kingdom,K02000001,2020/3/9,148,650,148,650
40,800,overview,United Kingdom,K02000001,2020/3/10,265,915,265,915
41,799,overview,United Kingdom,K02000001,2020/3/11,403,1318,403,1318
42,798,overview,United Kingdom,K02000001,2020/3/12,484,1802,484,1802
43,797,overview,United Kingdom,K02000001,2020/3/13,478,2280,478,2280
44,796,overview,United Kingdom,K02000001,2020/3/14,352,2632,352,2632
45,795,overview,United Kingdom,K02000001,2020/3/15,441,3073,441,3073
46,794,overview,United Kingdom,K02000001,2020/3/16,602,3675,602,3675
47,793,overview,United Kingdom,K02000001,2020/3/17,783,4458,783,4458
48,792,overview,United Kingdom,K02000001,2020/3/18,981,5439,981,5439
49,791,overview,United Kingdom,K02000001,2020/3/19,1042,6481,1042,6481
50,790,overview,United Kingdom,K02000001,2020/3/20,1252,7733,1252,7733
51,789,overview,United Kingdom,K02000001,2020/3/21,1181,8914,1181,8914
52,788,overview,United Kingdom,K02000001,2020/3/22,1363,10277,1363,10277
53,787,overview,United Kingdom,K02000001,2020/3/23,2290,12567,2290,12567
54,786,overview,United Kingdom,K02000001,2020/3/24,2354,14921,2354,14921
55,785,overview,United Kingdom,K02000001,2020/3/25,2666,17587,2666,17587
56,784,overview,United Kingdom,K02000001,2020/3/26,3039,20626,3039,20626
57,783,overview,United Kingdom,K02000001,2020/3/27,3154,23780,3154,23780
58,782,overview,United Kingdom,K02000001,2020/3/28,2774,26554,2774,26554
59,781,overview,United Kingdom,K02000001,2020/3/29,2818,29372,2818,29372
60,780,overview,United Kingdom,K02000001,2020/3/30,4195,33567,4195,33567
61,779,overview,United Kingdom,K02000001,2020/3/31,4463,38030,4463,38030
62,778,overview,United Kingdom,K02000001,2020/4/1,4891,42921,4891,42921
63,777,overview,United Kingdom,K02000001,2020/4/2,4824,47745,4824,47745
64,776,overview,United Kingdom,K02000001,2020/4/3,4852,52597,4852,52597
65,775,overview,United Kingdom,K02000001,2020/4/4,3976,56573,3976,56573
66,774,overview,United Kingdom,K02000001,2020/4/5,3556,60129,3556,60129
67,773,overview,United Kingdom,K02000001,2020/4/6,5273,65402,5273,65402
68,772,overview,United Kingdom,K02000001,2020/4/7,5477,70879,5477,70879
69,771,overview,United Kingdom,K02000001,2020/4/8,5146,76025,5146,76025
70,770,overview,United Kingdom,K02000001,2020/4/9,4875,80900,4875,80900
71,769,overview,United Kingdom,K02000001,2020/4/10,4327,85227,4327,85227
72,768,overview,United Kingdom,K02000001,2020/4/11,3585,88812,3585,88812
73,767,overview,United Kingdom,K02000001,2020/4/12,3507,92319,3507,92319
74,766,overview,United Kingdom,K02000001,2020/4/13,4203,96522,4203,96522
75,765,overview,United Kingdom,K02000001,2020/4/14,4335,100857,4335,100857
76,764,overview,United Kingdom,K02000001,2020/4/15,5070,105927,5070,105927
77,763,overview,United Kingdom,K02000001,2020/4/16,5292,111219,5292,111219
78,762,overview,United Kingdom,K02000001,2020/4/17,4977,116196,4977,116196
79,761,overview,United Kingdom,K02000001,2020/4/18,4743,120939,4743,120939
80,760,overview,United Kingdom,K02000001,2020/4/19,3881,124820,3881,124820
81,759,overview,United Kingdom,K02000001,2020/4/20,4441,129261,4441,129261
82,758,overview,United Kingdom,K02000001,2020/4/21,4795,134056,4795,134056
83,757,overview,United Kingdom,K02000001,2020/4/22,5517,139573,5517,139573
84,756,overview,United Kingdom,K02000001,2020/4/23,5167,144740,5167,144740
85,755,overview,United Kingdom,K02000001,2020/4/24,4961,149701,4961,149701
86,754,overview,United Kingdom,K02000001,2020/4/25,3757,153458,3757,153458
87,753,overview,United Kingdom,K02000001,2020/4/26,3476,156934,3476,156934
88,752,overview,United Kingdom,K02000001,2020/4/27,4739,161673,4739,161673
89,751,overview,United Kingdom,K02000001,2020/4/28,4719,166392,4719,166392
90,750,overview,United Kingdom,K02000001,2020/4/29,5433,171825,5433,171825
91,749,overview,United Kingdom,K02000001,2020/4/30,4961,176786,4961,176786
92,748,overview,United Kingdom,K02000001,2020/5/1,4766,181552,4766,181552
93,747,overview,United Kingdom,K02000001,2020/5/2,3258,184810,3258,184810
94,746,overview,United Kingdom,K02000001,2020/5/3,3002,187812,3002,187812
95,745,overview,United Kingdom,K02000001,2020/5/4,3398,191210,3398,191210
96,744,overview,United Kingdom,K02000001,2020/5/5,3686,194896,3686,194896
97,743,overview,United Kingdom,K02000001,2020/5/6,3832,198728,3832,198728
98,742,overview,United Kingdom,K02000001,2020/5/7,3787,202515,3787,202515
99,741,overview,United Kingdom,K02000001,2020/5/8,3064,205579,3064,205579
100,740,overview,United Kingdom,K02000001,2020/5/9,2170,207749,2170,207749
101,739,overview,United Kingdom,K02000001,2020/5/10,2337,210086,2337,210086
102,738,overview,United Kingdom,K02000001,2020/5/11,3612,213698,3612,213698
103,737,overview,United Kingdom,K02000001,2020/5/12,3410,217108,3410,217108
104,736,overview,United Kingdom,K02000001,2020/5/13,3330,220438,3330,220438
105,735,overview,United Kingdom,K02000001,2020/5/14,2630,223068,2630,223068
106,734,overview,United Kingdom,K02000001,2020/5/15,2530,225598,2530,225598
107,733,overview,United Kingdom,K02000001,2020/5/16,2082,227680,2081,227679
108,732,overview,United Kingdom,K02000001,2020/5/17,1837,229517,1837,229516
109,731,overview,United Kingdom,K02000001,2020/5/18,2581,232098,2577,232093
110,730,overview,United Kingdom,K02000001,2020/5/19,3063,235161,3060,235153
111,729,overview,United Kingdom,K02000001,2020/5/20,2719,237880,2719,237872
112,728,overview,United Kingdom,K02000001,2020/5/21,2567,240447,2565,240437
113,727,overview,United Kingdom,K02000001,2020/5/22,2057,242504,2056,242493
114,726,overview,United Kingdom,K02000001,2020/5/23,1532,244036,1529,244022
115,725,overview,United Kingdom,K02000001,2020/5/24,1373,245409,1370,245392
116,724,overview,United Kingdom,K02000001,2020/5/25,1625,247034,1622,247014
117,723,overview,United Kingdom,K02000001,2020/5/26,2070,249104,2069,249083
118,722,overview,United Kingdom,K02000001,2020/5/27,1825,250929,1823,250906
119,721,overview,United Kingdom,K02000001,2020/5/28,1757,252686,1753,252659
120,720,overview,United Kingdom,K02000001,2020/5/29,1531,254217,1528,254187
121,719,overview,United Kingdom,K02000001,2020/5/30,1132,255349,1129,255316
122,718,overview,United Kingdom,K02000001,2020/5/31,1080,256429,1080,256396
123,717,overview,United Kingdom,K02000001,2020/6/1,1439,257868,1438,257834
124,716,overview,United Kingdom,K02000001,2020/6/2,1492,259360,1489,259323
125,715,overview,United Kingdom,K02000001,2020/6/3,1369,260729,1365,260688
126,714,overview,United Kingdom,K02000001,2020/6/4,1249,261978,1248,261936
127,713,overview,United Kingdom,K02000001,2020/6/5,1123,263101,1120,263056
128,712,overview,United Kingdom,K02000001,2020/6/6,804,263905,801,263857
129,711,overview,United Kingdom,K02000001,2020/6/7,722,264627,721,264578
130,710,overview,United Kingdom,K02000001,2020/6/8,1099,265726,1097,265675
131,709,overview,United Kingdom,K02000001,2020/6/9,1165,266891,1162,266837
132,708,overview,United Kingdom,K02000001,2020/6/10,1196,268087,1193,268030
133,707,overview,United Kingdom,K02000001,2020/6/11,1013,269100,1006,269036
134,706,overview,United Kingdom,K02000001,2020/6/12,1053,270153,1052,270088
135,705,overview,United Kingdom,K02000001,2020/6/13,886,271039,884,270972
136,704,overview,United Kingdom,K02000001,2020/6/14,826,271865,826,271798
137,703,overview,United Kingdom,K02000001,2020/6/15,1045,272910,1043,272841
138,702,overview,United Kingdom,K02000001,2020/6/16,1103,274013,1098,273939
139,701,overview,United Kingdom,K02000001,2020/6/17,1017,275030,1012,274951
140,700,overview,United Kingdom,K02000001,2020/6/18,1022,276052,1022,275973
141,699,overview,United Kingdom,K02000001,2020/6/19,993,277045,988,276961
142,698,overview,United Kingdom,K02000001,2020/6/20,683,277728,681,277642
143,697,overview,United Kingdom,K02000001,2020/6/21,636,278364,634,278276
144,696,overview,United Kingdom,K02000001,2020/6/22,899,279263,892,279168
145,695,overview,United Kingdom,K02000001,2020/6/23,883,280146,877,280045
146,694,overview,United Kingdom,K02000001,2020/6/24,777,280923,774,280819
147,693,overview,United Kingdom,K02000001,2020/6/25,726,281649,724,281543
148,692,overview,United Kingdom,K02000001,2020/6/26,666,282315,665,282208
149,691,overview,United Kingdom,K02000001,2020/6/27,653,282968,648,282856
150,690,overview,United Kingdom,K02000001,2020/6/28,449,283417,446,283302
151,689,overview,United Kingdom,K02000001,2020/6/29,724,284141,718,284020
152,688,overview,United Kingdom,K02000001,2020/6/30,623,284764,618,284638
153,687,overview,United Kingdom,K02000001,2020/7/1,652,285416,647,285285
154,686,overview,United Kingdom,K02000001,2020/7/2,606,286022,601,285886
155,685,overview,United Kingdom,K02000001,2020/7/3,568,286590,563,286449
156,684,overview,United Kingdom,K02000001,2020/7/4,399,286989,398,286847
157,683,overview,United Kingdom,K02000001,2020/7/5,558,287547,556,287403
158,682,overview,United Kingdom,K02000001,2020/7/6,714,288261,706,288109
159,681,overview,United Kingdom,K02000001,2020/7/7,608,288869,601,288710
160,680,overview,United Kingdom,K02000001,2020/7/8,713,289582,705,289415
161,679,overview,United Kingdom,K02000001,2020/7/9,722,290304,713,290128
162,678,overview,United Kingdom,K02000001,2020/7/10,568,290872,563,290691
163,677,overview,United Kingdom,K02000001,2020/7/11,459,291331,455,291146
164,676,overview,United Kingdom,K02000001,2020/7/12,366,291697,364,291510
165,675,overview,United Kingdom,K02000001,2020/7/13,740,292437,736,292246
166,674,overview,United Kingdom,K02000001,2020/7/14,705,293142,698,292944
167,673,overview,United Kingdom,K02000001,2020/7/15,777,293919,771,293715
168,672,overview,United Kingdom,K02000001,2020/7/16,712,294631,704,294419
169,671,overview,United Kingdom,K02000001,2020/7/17,582,295213,578,294997
170,670,overview,United Kingdom,K02000001,2020/7/18,505,295718,499,295496
171,669,overview,United Kingdom,K02000001,2020/7/19,448,296166,443,295939
172,668,overview,United Kingdom,K02000001,2020/7/20,830,296996,817,296756
173,667,overview,United Kingdom,K02000001,2020/7/21,788,297784,776,297532
174,666,overview,United Kingdom,K02000001,2020/7/22,816,298600,804,298336
175,665,overview,United Kingdom,K02000001,2020/7/23,808,299408,803,299139
176,664,overview,United Kingdom,K02000001,2020/7/24,774,300182,764,299903
177,663,overview,United Kingdom,K02000001,2020/7/25,530,300712,527,300430
178,662,overview,United Kingdom,K02000001,2020/7/26,563,301275,560,300990
179,661,overview,United Kingdom,K02000001,2020/7/27,869,302144,857,301847
180,660,overview,United Kingdom,K02000001,2020/7/28,856,303000,836,302683
181,659,overview,United Kingdom,K02000001,2020/7/29,1062,304062,1043,303726
182,658,overview,United Kingdom,K02000001,2020/7/30,946,305008,926,304652
183,657,overview,United Kingdom,K02000001,2020/7/31,697,305705,686,305338
184,656,overview,United Kingdom,K02000001,2020/8/1,559,306264,552,305890
185,655,overview,United Kingdom,K02000001,2020/8/2,564,306828,558,306448
186,654,overview,United Kingdom,K02000001,2020/8/3,1060,307888,1042,307490
187,653,overview,United Kingdom,K02000001,2020/8/4,1065,308953,1037,308527
188,652,overview,United Kingdom,K02000001,2020/8/5,1092,310045,1067,309594
189,651,overview,United Kingdom,K02000001,2020/8/6,1105,311150,1089,310683
190,650,overview,United Kingdom,K02000001,2020/8/7,973,312123,958,311641
191,649,overview,United Kingdom,K02000001,2020/8/8,710,312833,704,312345
192,648,overview,United Kingdom,K02000001,2020/8/9,627,313460,622,312967
193,647,overview,United Kingdom,K02000001,2020/8/10,1499,314959,1482,314449
194,646,overview,United Kingdom,K02000001,2020/8/11,1378,316337,1348,315797
195,645,overview,United Kingdom,K02000001,2020/8/12,1242,317579,1221,317018
196,644,overview,United Kingdom,K02000001,2020/8/13,1156,318735,1149,318167
197,643,overview,United Kingdom,K02000001,2020/8/14,1185,319920,1164,319331
198,642,overview,United Kingdom,K02000001,2020/8/15,714,320634,710,320041
199,641,overview,United Kingdom,K02000001,2020/8/16,602,321236,596,320637
200,640,overview,United Kingdom,K02000001,2020/8/17,1298,322534,1286,321923
201,639,overview,United Kingdom,K02000001,2020/8/18,1116,323650,1099,323022
202,638,overview,United Kingdom,K02000001,2020/8/19,1282,324932,1258,324280
203,637,overview,United Kingdom,K02000001,2020/8/20,1498,326430,1470,325750
204,636,overview,United Kingdom,K02000001,2020/8/21,1218,327648,1198,326948
205,635,overview,United Kingdom,K02000001,2020/8/22,842,328490,836,327784
206,634,overview,United Kingdom,K02000001,2020/8/23,831,329321,828,328612
207,633,overview,United Kingdom,K02000001,2020/8/24,1301,330622,1289,329901
208,632,overview,United Kingdom,K02000001,2020/8/25,1270,331892,1250,331151
209,631,overview,United Kingdom,K02000001,2020/8/26,1388,333280,1359,332510
210,630,overview,United Kingdom,K02000001,2020/8/27,1591,334871,1563,334073
211,629,overview,United Kingdom,K02000001,2020/8/28,1632,336503,1621,335694
212,628,overview,United Kingdom,K02000001,2020/8/29,1230,337733,1225,336919
213,627,overview,United Kingdom,K02000001,2020/8/30,1171,338904,1167,338086
214,626,overview,United Kingdom,K02000001,2020/8/31,1513,340417,1506,339592
215,625,overview,United Kingdom,K02000001,2020/9/1,2288,342705,2267,341859
216,624,overview,United Kingdom,K02000001,2020/9/2,3077,345782,3015,344874
217,623,overview,United Kingdom,K02000001,2020/9/3,3152,348934,3105,347979
218,622,overview,United Kingdom,K02000001,2020/9/4,3092,352026,3057,351036
219,621,overview,United Kingdom,K02000001,2020/9/5,2551,354577,2544,353580
220,620,overview,United Kingdom,K02000001,2020/9/6,2465,357042,2455,356035
221,619,overview,United Kingdom,K02000001,2020/9/7,3931,360973,3878,359913
222,618,overview,United Kingdom,K02000001,2020/9/8,3370,364343,3330,363243
223,617,overview,United Kingdom,K02000001,2020/9/9,3365,367708,3343,366586
224,616,overview,United Kingdom,K02000001,2020/9/10,3628,371336,3606,370192
225,615,overview,United Kingdom,K02000001,2020/9/11,3324,374660,3294,373486
226,614,overview,United Kingdom,K02000001,2020/9/12,2670,377330,2659,376145
227,613,overview,United Kingdom,K02000001,2020/9/13,2154,379484,2147,378292
228,612,overview,United Kingdom,K02000001,2020/9/14,3428,382912,3399,381691
229,611,overview,United Kingdom,K02000001,2020/9/15,3551,386463,3521,385212
230,610,overview,United Kingdom,K02000001,2020/9/16,4399,390862,4371,389583
231,609,overview,United Kingdom,K02000001,2020/9/17,4675,395537,4653,394236
232,608,overview,United Kingdom,K02000001,2020/9/18,4973,400510,4946,399182
233,607,overview,United Kingdom,K02000001,2020/9/19,4889,405399,4884,404066
234,606,overview,United Kingdom,K02000001,2020/9/20,5340,410739,5333,409399
235,605,overview,United Kingdom,K02000001,2020/9/21,5627,416366,5611,415010
236,604,overview,United Kingdom,K02000001,2020/9/22,6441,422807,6418,421428
237,603,overview,United Kingdom,K02000001,2020/9/23,7096,429903,7072,428500
238,602,overview,United Kingdom,K02000001,2020/9/24,7682,437585,7658,436158
239,601,overview,United Kingdom,K02000001,2020/9/25,7318,444903,7299,443457
240,600,overview,United Kingdom,K02000001,2020/9/26,6809,451712,6801,450258
241,599,overview,United Kingdom,K02000001,2020/9/27,7023,458735,7012,457270
242,598,overview,United Kingdom,K02000001,2020/9/28,9983,468718,9963,467233
243,597,overview,United Kingdom,K02000001,2020/9/29,10367,479085,10325,477558
244,596,overview,United Kingdom,K02000001,2020/9/30,12717,491802,12683,490241
245,595,overview,United Kingdom,K02000001,2020/10/1,13358,505160,13327,503568
246,594,overview,United Kingdom,K02000001,2020/10/2,13854,519014,13823,517391
247,593,overview,United Kingdom,K02000001,2020/10/3,11667,530681,11657,529048
248,592,overview,United Kingdom,K02000001,2020/10/4,11954,542635,11945,540993
249,591,overview,United Kingdom,K02000001,2020/10/5,16755,559390,16716,557709
250,590,overview,United Kingdom,K02000001,2020/10/6,17250,576640,17219,574928
251,589,overview,United Kingdom,K02000001,2020/10/7,18575,595215,18544,593472
252,588,overview,United Kingdom,K02000001,2020/10/8,18427,613642,18404,611876
253,587,overview,United Kingdom,K02000001,2020/10/9,15903,629545,15869,627745
254,586,overview,United Kingdom,K02000001,2020/10/10,12652,642197,12636,640381
255,585,overview,United Kingdom,K02000001,2020/10/11,12213,654410,12203,652584
256,584,overview,United Kingdom,K02000001,2020/10/12,19710,674120,19681,672265
257,583,overview,United Kingdom,K02000001,2020/10/13,19135,693255,19100,691365
258,582,overview,United Kingdom,K02000001,2020/10/14,19933,713188,19906,711271
259,581,overview,United Kingdom,K02000001,2020/10/15,18639,731827,18599,729870
260,580,overview,United Kingdom,K02000001,2020/10/16,17938,749765,17900,747770
261,579,overview,United Kingdom,K02000001,2020/10/17,14888,764653,14870,762640
262,578,overview,United Kingdom,K02000001,2020/10/18,14330,778983,14309,776949
263,577,overview,United Kingdom,K02000001,2020/10/19,25926,804909,25892,802841
264,576,overview,United Kingdom,K02000001,2020/10/20,25680,830589,25631,828472
265,575,overview,United Kingdom,K02000001,2020/10/21,25785,856374,25754,854226
266,574,overview,United Kingdom,K02000001,2020/10/22,23497,879871,23473,877699
267,573,overview,United Kingdom,K02000001,2020/10/23,21714,901585,21678,899377
268,572,overview,United Kingdom,K02000001,2020/10/24,16464,918049,16445,915822
269,571,overview,United Kingdom,K02000001,2020/10/25,15905,933954,15893,931715
270,570,overview,United Kingdom,K02000001,2020/10/26,26807,960761,26779,958494
271,569,overview,United Kingdom,K02000001,2020/10/27,24360,985121,24331,982825
272,568,overview,United Kingdom,K02000001,2020/10/28,23907,1009028,23876,1006701
273,567,overview,United Kingdom,K02000001,2020/10/29,23649,1032677,23608,1030309
274,566,overview,United Kingdom,K02000001,2020/10/30,22896,1055573,22864,1053173
275,565,overview,United Kingdom,K02000001,2020/10/31,16702,1072275,16680,1069853
276,564,overview,United Kingdom,K02000001,2020/11/1,16001,1088276,15976,1085829
277,563,overview,United Kingdom,K02000001,2020/11/2,32003,1120279,31955,1117784
278,562,overview,United Kingdom,K02000001,2020/11/3,25989,1146268,25939,1143723
279,561,overview,United Kingdom,K02000001,2020/11/4,24055,1170323,24017,1167740
280,560,overview,United Kingdom,K02000001,2020/11/5,24102,1194425,24056,1191796
281,559,overview,United Kingdom,K02000001,2020/11/6,23714,1218139,23674,1215470
282,558,overview,United Kingdom,K02000001,2020/11/7,18784,1236923,18767,1234237
283,557,overview,United Kingdom,K02000001,2020/11/8,20252,1257175,20228,1254465
284,556,overview,United Kingdom,K02000001,2020/11/9,31556,1288731,31503,1285968
285,555,overview,United Kingdom,K02000001,2020/11/10,27828,1316559,27782,1313750
286,554,overview,United Kingdom,K02000001,2020/11/11,27792,1344351,27749,1341499
287,553,overview,United Kingdom,K02000001,2020/11/12,24876,1369227,24837,1366336
288,552,overview,United Kingdom,K02000001,2020/11/13,24438,1393665,24407,1390743
289,551,overview,United Kingdom,K02000001,2020/11/14,18258,1411923,18238,1408981
290,550,overview,United Kingdom,K02000001,2020/11/15,16258,1428181,16243,1425224
291,549,overview,United Kingdom,K02000001,2020/11/16,27006,1455187,26969,1452193
292,548,overview,United Kingdom,K02000001,2020/11/17,23531,1478718,23494,1475687
293,547,overview,United Kingdom,K02000001,2020/11/18,21118,1499836,21075,1496762
294,546,overview,United Kingdom,K02000001,2020/11/19,18074,1517910,18042,1514804
295,545,overview,United Kingdom,K02000001,2020/11/20,17134,1535044,17100,1531904
296,544,overview,United Kingdom,K02000001,2020/11/21,12556,1547600,12541,1544445
297,543,overview,United Kingdom,K02000001,2020/11/22,11913,1559513,11898,1556343
298,542,overview,United Kingdom,K02000001,2020/11/23,19082,1578595,19046,1575389
299,541,overview,United Kingdom,K02000001,2020/11/24,16705,1595300,16668,1592057
300,540,overview,United Kingdom,K02000001,2020/11/25,16857,1612157,16823,1608880
301,539,overview,United Kingdom,K02000001,2020/11/26,14817,1626974,14781,1623661
302,538,overview,United Kingdom,K02000001,2020/11/27,14597,1641571,14568,1638229
303,537,overview,United Kingdom,K02000001,2020/11/28,11105,1652676,11085,1649314
304,536,overview,United Kingdom,K02000001,2020/11/29,10874,1663550,10854,1660168
305,535,overview,United Kingdom,K02000001,2020/11/30,18265,1681815,18230,1678398
306,534,overview,United Kingdom,K02000001,2020/12/1,16746,1698561,16699,1695097
307,533,overview,United Kingdom,K02000001,2020/12/2,16748,1715309,16709,1711806
308,532,overview,United Kingdom,K02000001,2020/12/3,15926,1731235,15879,1727685
309,531,overview,United Kingdom,K02000001,2020/12/4,15866,1747101,15836,1743521
310,530,overview,United Kingdom,K02000001,2020/12/5,12917,1760018,12905,1756426
311,529,overview,United Kingdom,K02000001,2020/12/6,13765,1773783,13737,1770163
312,528,overview,United Kingdom,K02000001,2020/12/7,21644,1795427,21589,1791752
313,527,overview,United Kingdom,K02000001,2020/12/8,21097,1816524,21049,1812801
314,526,overview,United Kingdom,K02000001,2020/12/9,21937,1838461,21878,1834679
315,525,overview,United Kingdom,K02000001,2020/12/10,22927,1861388,22880,1857559
316,524,overview,United Kingdom,K02000001,2020/12/11,24425,1885813,24373,1881932
317,523,overview,United Kingdom,K02000001,2020/12/12,19592,1905405,19552,1901484
318,522,overview,United Kingdom,K02000001,2020/12/13,22279,1927684,22236,1923720
319,521,overview,United Kingdom,K02000001,2020/12/14,35221,1962905,35144,1958864
320,520,overview,United Kingdom,K02000001,2020/12/15,34414,1997319,34360,1993224
321,519,overview,United Kingdom,K02000001,2020/12/16,35438,2032757,35378,2028602
322,518,overview,United Kingdom,K02000001,2020/12/17,34440,2067197,34379,2062981
323,517,overview,United Kingdom,K02000001,2020/12/18,36417,2103614,36358,2099339
324,516,overview,United Kingdom,K02000001,2020/12/19,25589,2129203,25552,2124891
325,515,overview,United Kingdom,K02000001,2020/12/20,33064,2162267,33020,2157911
326,514,overview,United Kingdom,K02000001,2020/12/21,48192,2210459,48117,2206028
327,513,overview,United Kingdom,K02000001,2020/12/22,46475,2256934,46374,2252402
328,512,overview,United Kingdom,K02000001,2020/12/23,42936,2299870,42862,2295264
329,511,overview,United Kingdom,K02000001,2020/12/24,32391,2332261,32337,2327601
330,510,overview,United Kingdom,K02000001,2020/12/25,14419,2346680,14395,2341996
331,509,overview,United Kingdom,K02000001,2020/12/26,41109,2387789,41062,2383058
332,508,overview,United Kingdom,K02000001,2020/12/27,48519,2436308,48457,2431515
333,507,overview,United Kingdom,K02000001,2020/12/28,46407,2482715,46344,2477859
334,506,overview,United Kingdom,K02000001,2020/12/29,83088,2565803,82928,2560787
335,505,overview,United Kingdom,K02000001,2020/12/30,72161,2637964,72010,2632797
336,504,overview,United Kingdom,K02000001,2020/12/31,53945,2691909,53860,2686657
337,503,overview,United Kingdom,K02000001,2021/1/1,32482,2724391,32428,2719085
338,502,overview,United Kingdom,K02000001,2021/1/2,61654,2786045,61558,2780643
339,501,overview,United Kingdom,K02000001,2021/1/3,56332,2842377,56245,2836888
340,500,overview,United Kingdom,K02000001,2021/1/4,77970,2920347,77772,2914660
341,499,overview,United Kingdom,K02000001,2021/1/5,66635,2986982,66434,2981094
342,498,overview,United Kingdom,K02000001,2021/1/6,58783,3045765,58627,3039721
343,497,overview,United Kingdom,K02000001,2021/1/7,53187,3098952,53040,3092761
344,496,overview,United Kingdom,K02000001,2021/1/8,48104,3147056,47958,3140719
345,495,overview,United Kingdom,K02000001,2021/1/9,40035,3187091,39952,3180671
346,494,overview,United Kingdom,K02000001,2021/1/10,37174,3224265,37105,3217776
347,493,overview,United Kingdom,K02000001,2021/1/11,58591,3282856,58380,3276156
348,492,overview,United Kingdom,K02000001,2021/1/12,50647,3333503,50435,3326591
349,491,overview,United Kingdom,K02000001,2021/1/13,46506,3380009,46377,3372968
350,490,overview,United Kingdom,K02000001,2021/1/14,43473,3423482,43316,3416284
351,489,overview,United Kingdom,K02000001,2021/1/15,41450,3464932,41313,3457597
352,488,overview,United Kingdom,K02000001,2021/1/16,31248,3496180,31160,3488757
353,487,overview,United Kingdom,K02000001,2021/1/17,29592,3525772,29507,3518264
354,486,overview,United Kingdom,K02000001,2021/1/18,45956,3571728,45752,3564016
355,485,overview,United Kingdom,K02000001,2021/1/19,40526,3612254,40342,3604358
356,484,overview,United Kingdom,K02000001,2021/1/20,35985,3648239,35824,3640182
357,483,overview,United Kingdom,K02000001,2021/1/21,32501,3680740,32370,3672552
358,482,overview,United Kingdom,K02000001,2021/1/22,30330,3711070,30208,3702760
359,481,overview,United Kingdom,K02000001,2021/1/23,22344,3733414,22270,3725030
360,480,overview,United Kingdom,K02000001,2021/1/24,17554,3750968,17512,3742542
361,479,overview,United Kingdom,K02000001,2021/1/25,30736,3781704,30588,3773130
362,478,overview,United Kingdom,K02000001,2021/1/26,27730,3809434,27587,3800717
363,477,overview,United Kingdom,K02000001,2021/1/27,26303,3835737,26189,3826906
364,476,overview,United Kingdom,K02000001,2021/1/28,24772,3860509,24659,3851565
365,475,overview,United Kingdom,K02000001,2021/1/29,22433,3882942,22329,3873894
366,474,overview,United Kingdom,K02000001,2021/1/30,17167,3900109,17098,3890992
367,473,overview,United Kingdom,K02000001,2021/1/31,15783,3915892,15726,3906718
368,472,overview,United Kingdom,K02000001,2021/2/1,22971,3938863,22852,3929570
369,471,overview,United Kingdom,K02000001,2021/2/2,20267,3959130,20152,3949722
370,470,overview,United Kingdom,K02000001,2021/2/3,19914,3979044,19787,3969509
371,469,overview,United Kingdom,K02000001,2021/2/4,18492,3997536,18395,3987904
372,468,overview,United Kingdom,K02000001,2021/2/5,16308,4013844,16201,4004105
373,467,overview,United Kingdom,K02000001,2021/2/6,12320,4026164,12265,4016370
374,466,overview,United Kingdom,K02000001,2021/2/7,11664,4037828,11619,4027989
375,465,overview,United Kingdom,K02000001,2021/2/8,16194,4054022,16079,4044068
376,464,overview,United Kingdom,K02000001,2021/2/9,14225,4068247,14096,4058164
377,463,overview,United Kingdom,K02000001,2021/2/10,13899,4082146,13780,4071944
378,462,overview,United Kingdom,K02000001,2021/2/11,13139,4095285,13052,4084996
379,461,overview,United Kingdom,K02000001,2021/2/12,12573,4107858,12459,4097455
380,460,overview,United Kingdom,K02000001,2021/2/13,9034,4116892,8977,4106432
381,459,overview,United Kingdom,K02000001,2021/2/14,8994,4125886,8945,4115377
382,458,overview,United Kingdom,K02000001,2021/2/15,14735,4140621,14561,4129938
383,457,overview,United Kingdom,K02000001,2021/2/16,12941,4153562,12820,4142758
384,456,overview,United Kingdom,K02000001,2021/2/17,11942,4165504,11814,4154572
385,455,overview,United Kingdom,K02000001,2021/2/18,11794,4177298,11680,4166252
386,454,overview,United Kingdom,K02000001,2021/2/19,10728,4188026,10603,4176855
387,453,overview,United Kingdom,K02000001,2021/2/20,8312,4196338,8247,4185102
388,452,overview,United Kingdom,K02000001,2021/2/21,8097,4204435,8041,4193143
389,451,overview,United Kingdom,K02000001,2021/2/22,11655,4216090,11473,4204616
390,450,overview,United Kingdom,K02000001,2021/2/23,9762,4225852,9632,4214248
391,449,overview,United Kingdom,K02000001,2021/2/24,8845,4234697,8732,4222980
392,448,overview,United Kingdom,K02000001,2021/2/25,8025,4242722,7901,4230881
393,447,overview,United Kingdom,K02000001,2021/2/26,6783,4249505,6713,4237594
394,446,overview,United Kingdom,K02000001,2021/2/27,4949,4254454,4910,4242504
395,445,overview,United Kingdom,K02000001,2021/2/28,4873,4259327,4826,4247330
396,444,overview,United Kingdom,K02000001,2021/3/1,7191,4266518,7042,4254372
397,443,overview,United Kingdom,K02000001,2021/3/2,6919,4273437,6801,4261173
398,442,overview,United Kingdom,K02000001,2021/3/3,6172,4279609,6101,4267274
399,441,overview,United Kingdom,K02000001,2021/3/4,5937,4285546,5862,4273136
400,440,overview,United Kingdom,K02000001,2021/3/5,5467,4291013,5409,4278545
401,439,overview,United Kingdom,K02000001,2021/3/6,4628,4295641,4592,4283137
402,438,overview,United Kingdom,K02000001,2021/3/7,4410,4300051,4371,4287508
403,437,overview,United Kingdom,K02000001,2021/3/8,6890,4306941,6789,4294297
404,436,overview,United Kingdom,K02000001,2021/3/9,6487,4313428,6385,4300682
405,435,overview,United Kingdom,K02000001,2021/3/10,6251,4319679,6173,4306855
406,434,overview,United Kingdom,K02000001,2021/3/11,5933,4325612,5876,4312731
407,433,overview,United Kingdom,K02000001,2021/3/12,5716,4331328,5664,4318395
408,432,overview,United Kingdom,K02000001,2021/3/13,4379,4335707,4340,4322735
409,431,overview,United Kingdom,K02000001,2021/3/14,4425,4340132,4384,4327119
410,430,overview,United Kingdom,K02000001,2021/3/15,6697,4346829,6633,4333752
411,429,overview,United Kingdom,K02000001,2021/3/16,5849,4352678,5791,4339543
412,428,overview,United Kingdom,K02000001,2021/3/17,5976,4358654,5913,4345456
413,427,overview,United Kingdom,K02000001,2021/3/18,5623,4364277,5575,4351031
414,426,overview,United Kingdom,K02000001,2021/3/19,5176,4369453,5111,4356142
415,425,overview,United Kingdom,K02000001,2021/3/20,4246,4373699,4204,4360346
416,424,overview,United Kingdom,K02000001,2021/3/21,5388,4379087,5325,4365671
417,423,overview,United Kingdom,K02000001,2021/3/22,6458,4385545,6378,4372049
418,422,overview,United Kingdom,K02000001,2021/3/23,5481,4391026,5398,4377447
419,421,overview,United Kingdom,K02000001,2021/3/24,6222,4397248,6129,4383576
420,420,overview,United Kingdom,K02000001,2021/3/25,5616,4402864,5534,4389110
421,419,overview,United Kingdom,K02000001,2021/3/26,4567,4407431,4506,4393616
422,418,overview,United Kingdom,K02000001,2021/3/27,3731,4411162,3683,4397299
423,417,overview,United Kingdom,K02000001,2021/3/28,5029,4416191,4959,4402258
424,416,overview,United Kingdom,K02000001,2021/3/29,4196,4420387,4113,4406371
425,415,overview,United Kingdom,K02000001,2021/3/30,3779,4424166,3702,4410073
426,414,overview,United Kingdom,K02000001,2021/3/31,3967,4428133,3899,4413972
427,413,overview,United Kingdom,K02000001,2021/4/1,3674,4431807,3600,4417572
428,412,overview,United Kingdom,K02000001,2021/4/2,2747,4434554,2701,4420273
429,411,overview,United Kingdom,K02000001,2021/4/3,2506,4437060,2478,4422751
430,410,overview,United Kingdom,K02000001,2021/4/4,2413,4439473,2367,4425118
431,409,overview,United Kingdom,K02000001,2021/4/5,2744,4442217,2681,4427799
432,408,overview,United Kingdom,K02000001,2021/4/6,3312,4445529,3221,4431020
433,407,overview,United Kingdom,K02000001,2021/4/7,3253,4448782,3170,4434190
434,406,overview,United Kingdom,K02000001,2021/4/8,3147,4451929,3057,4437247
435,405,overview,United Kingdom,K02000001,2021/4/9,2952,4454881,2876,4440123
436,404,overview,United Kingdom,K02000001,2021/4/10,2380,4457261,2333,4442456
437,403,overview,United Kingdom,K02000001,2021/4/11,2376,4459637,2334,4444790
438,402,overview,United Kingdom,K02000001,2021/4/12,2880,4462517,2785,4447575
439,401,overview,United Kingdom,K02000001,2021/4/13,2495,4465012,2402,4449977
440,400,overview,United Kingdom,K02000001,2021/4/14,2512,4467524,2433,4452410
441,399,overview,United Kingdom,K02000001,2021/4/15,2345,4469869,2260,4454670
442,398,overview,United Kingdom,K02000001,2021/4/16,2347,4472216,2275,4456945
443,397,overview,United Kingdom,K02000001,2021/4/17,1722,4473938,1678,4458623
444,396,overview,United Kingdom,K02000001,2021/4/18,2584,4476522,2510,4461133
445,395,overview,United Kingdom,K02000001,2021/4/19,2738,4479260,2633,4463766
446,394,overview,United Kingdom,K02000001,2021/4/20,2541,4481801,2417,4466183
447,393,overview,United Kingdom,K02000001,2021/4/21,2709,4484510,2614,4468797
448,392,overview,United Kingdom,K02000001,2021/4/22,2409,4486919,2300,4471097
449,391,overview,United Kingdom,K02000001,2021/4/23,2020,4488939,1931,4473028
450,390,overview,United Kingdom,K02000001,2021/4/24,1564,4490503,1514,4474542
451,389,overview,United Kingdom,K02000001,2021/4/25,2119,4492622,2046,4476588
452,388,overview,United Kingdom,K02000001,2021/4/26,2627,4495249,2512,4479100
453,387,overview,United Kingdom,K02000001,2021/4/27,2177,4497426,2105,4481205
454,386,overview,United Kingdom,K02000001,2021/4/28,2499,4499925,2415,4483620
455,385,overview,United Kingdom,K02000001,2021/4/29,2230,4502155,2138,4485758
456,384,overview,United Kingdom,K02000001,2021/4/30,1825,4503980,1741,4487499
457,383,overview,United Kingdom,K02000001,2021/5/1,1431,4505411,1379,4488878
458,382,overview,United Kingdom,K02000001,2021/5/2,1521,4506932,1467,4490345
459,381,overview,United Kingdom,K02000001,2021/5/3,2084,4509016,2024,4492369
460,380,overview,United Kingdom,K02000001,2021/5/4,2550,4511566,2459,4494828
461,379,overview,United Kingdom,K02000001,2021/5/5,2569,4514135,2468,4497296
462,378,overview,United Kingdom,K02000001,2021/5/6,2325,4516460,2235,4499531
463,377,overview,United Kingdom,K02000001,2021/5/7,1981,4518441,1909,4501440
464,376,overview,United Kingdom,K02000001,2021/5/8,1608,4520049,1561,4503001
465,375,overview,United Kingdom,K02000001,2021/5/9,2307,4522356,2229,4505230
466,374,overview,United Kingdom,K02000001,2021/5/10,2808,4525164,2725,4507955
467,373,overview,United Kingdom,K02000001,2021/5/11,2328,4527492,2251,4510206
468,372,overview,United Kingdom,K02000001,2021/5/12,2334,4529826,2243,4512449
469,371,overview,United Kingdom,K02000001,2021/5/13,2182,4532008,2112,4514561
470,370,overview,United Kingdom,K02000001,2021/5/14,1936,4533944,1864,4516425
471,369,overview,United Kingdom,K02000001,2021/5/15,1626,4535570,1583,4518008
472,368,overview,United Kingdom,K02000001,2021/5/16,1922,4537492,1866,4519874
473,367,overview,United Kingdom,K02000001,2021/5/17,2858,4540350,2765,4522639
474,366,overview,United Kingdom,K02000001,2021/5/18,2812,4543162,2725,4525364
475,365,overview,United Kingdom,K02000001,2021/5/19,2812,4545974,2736,4528100
476,364,overview,United Kingdom,K02000001,2021/5/20,2517,4548491,2432,4530532
477,363,overview,United Kingdom,K02000001,2021/5/21,2365,4550856,2309,4532841
478,362,overview,United Kingdom,K02000001,2021/5/22,2000,4552856,1940,4534781
479,361,overview,United Kingdom,K02000001,2021/5/23,2326,4555182,2262,4537043
480,360,overview,United Kingdom,K02000001,2021/5/24,3368,4558550,3265,4540308
481,359,overview,United Kingdom,K02000001,2021/5/25,3427,4561977,3329,4543637
482,358,overview,United Kingdom,K02000001,2021/5/26,3921,4565898,3831,4547468
483,357,overview,United Kingdom,K02000001,2021/5/27,3747,4569645,3648,4551116
484,356,overview,United Kingdom,K02000001,2021/5/28,3589,4573234,3508,4554624
485,355,overview,United Kingdom,K02000001,2021/5/29,2999,4576233,2952,4557576
486,354,overview,United Kingdom,K02000001,2021/5/30,3164,4579397,3106,4560682
487,353,overview,United Kingdom,K02000001,2021/5/31,3897,4583294,3802,4564484
488,352,overview,United Kingdom,K02000001,2021/6/1,5431,4588725,5286,4569770
489,351,overview,United Kingdom,K02000001,2021/6/2,6168,4594893,6071,4575841
490,350,overview,United Kingdom,K02000001,2021/6/3,6256,4601149,6129,4581970
491,349,overview,United Kingdom,K02000001,2021/6/4,5860,4607009,5758,4587728
492,348,overview,United Kingdom,K02000001,2021/6/5,4731,4611740,4661,4592389
493,347,overview,United Kingdom,K02000001,2021/6/6,5533,4617273,5432,4597821
494,346,overview,United Kingdom,K02000001,2021/6/7,7945,4625218,7789,4605610
495,345,overview,United Kingdom,K02000001,2021/6/8,7896,4633114,7720,4613330
496,344,overview,United Kingdom,K02000001,2021/6/9,8210,4641324,8071,4621401
497,343,overview,United Kingdom,K02000001,2021/6/10,8042,4649366,7881,4629282
498,342,overview,United Kingdom,K02000001,2021/6/11,7619,4656985,7466,4636748
499,341,overview,United Kingdom,K02000001,2021/6/12,6284,4663269,6163,4642911
500,340,overview,United Kingdom,K02000001,2021/6/13,7135,4670404,7009,4649920
501,339,overview,United Kingdom,K02000001,2021/6/14,10362,4680766,10171,4660091
502,338,overview,United Kingdom,K02000001,2021/6/15,10796,4691562,10561,4670652
503,337,overview,United Kingdom,K02000001,2021/6/16,11052,4702614,10857,4681509
504,336,overview,United Kingdom,K02000001,2021/6/17,11106,4713720,10856,4692365
505,335,overview,United Kingdom,K02000001,2021/6/18,10320,4724040,10099,4702464
506,334,overview,United Kingdom,K02000001,2021/6/19,8446,4732486,8299,4710763
507,333,overview,United Kingdom,K02000001,2021/6/20,10088,4742574,9927,4720690
508,332,overview,United Kingdom,K02000001,2021/6/21,16307,4758881,16032,4736722
509,331,overview,United Kingdom,K02000001,2021/6/22,17403,4776284,17097,4753819
510,330,overview,United Kingdom,K02000001,2021/6/23,18350,4794634,18023,4771842
511,329,overview,United Kingdom,K02000001,2021/6/24,18712,4813346,18404,4790246
512,328,overview,United Kingdom,K02000001,2021/6/25,18169,4831515,17866,4808112
513,327,overview,United Kingdom,K02000001,2021/6/26,16300,4847815,16058,4824170
514,326,overview,United Kingdom,K02000001,2021/6/27,18502,4866317,18226,4842396
515,325,overview,United Kingdom,K02000001,2021/6/28,28418,4894735,27940,4870336
516,324,overview,United Kingdom,K02000001,2021/6/29,28199,4922934,27788,4898124
517,323,overview,United Kingdom,K02000001,2021/6/30,28922,4951856,28519,4926643
518,322,overview,United Kingdom,K02000001,2021/7/1,28794,4980650,28310,4954953
519,321,overview,United Kingdom,K02000001,2021/7/2,26340,5006990,25980,4980933
520,320,overview,United Kingdom,K02000001,2021/7/3,24007,5030997,23708,5004641
521,319,overview,United Kingdom,K02000001,2021/7/4,25155,5056152,24834,5029475
522,318,overview,United Kingdom,K02000001,2021/7/5,34897,5091049,34394,5063869
523,317,overview,United Kingdom,K02000001,2021/7/6,36040,5127089,35576,5099445
524,316,overview,United Kingdom,K02000001,2021/7/7,38593,5165682,38085,5137530
525,315,overview,United Kingdom,K02000001,2021/7/8,34000,5199682,33576,5171106
526,314,overview,United Kingdom,K02000001,2021/7/9,32799,5232481,32394,5203500
527,313,overview,United Kingdom,K02000001,2021/7/10,28373,5260854,28055,5231555
528,312,overview,United Kingdom,K02000001,2021/7/11,30502,5291356,30183,5261738
529,311,overview,United Kingdom,K02000001,2021/7/12,44505,5335861,43947,5305685
530,310,overview,United Kingdom,K02000001,2021/7/13,47704,5383565,47069,5352754
531,309,overview,United Kingdom,K02000001,2021/7/14,54909,5438474,54190,5406944
532,308,overview,United Kingdom,K02000001,2021/7/15,61996,5500470,61194,5468138
533,307,overview,United Kingdom,K02000001,2021/7/16,55262,5555732,54601,5522739
534,306,overview,United Kingdom,K02000001,2021/7/17,38473,5594205,38064,5560803
535,305,overview,United Kingdom,K02000001,2021/7/18,36180,5630385,35756,5596559
536,304,overview,United Kingdom,K02000001,2021/7/19,47912,5678297,47281,5643840
537,303,overview,United Kingdom,K02000001,2021/7/20,39871,5718168,39290,5683130
538,302,overview,United Kingdom,K02000001,2021/7/21,35535,5753703,35114,5718244
539,301,overview,United Kingdom,K02000001,2021/7/22,31274,5784977,30908,5749152
540,300,overview,United Kingdom,K02000001,2021/7/23,27766,5812743,27426,5776578
541,299,overview,United Kingdom,K02000001,2021/7/24,22851,5835594,22567,5799145
542,298,overview,United Kingdom,K02000001,2021/7/25,22172,5857766,21892,5821037
543,297,overview,United Kingdom,K02000001,2021/7/26,29977,5887743,29566,5850603
544,296,overview,United Kingdom,K02000001,2021/7/27,29576,5917319,29151,5879754
545,295,overview,United Kingdom,K02000001,2021/7/28,30237,5947556,29831,5909585
546,294,overview,United Kingdom,K02000001,2021/7/29,28430,5975986,28047,5937632
547,293,overview,United Kingdom,K02000001,2021/7/30,24746,6000732,24400,5962032
548,292,overview,United Kingdom,K02000001,2021/7/31,20567,6021299,20267,5982299
549,291,overview,United Kingdom,K02000001,2021/8/1,20899,6042198,20636,6002935
550,290,overview,United Kingdom,K02000001,2021/8/2,29835,6072033,29413,6032348
551,289,overview,United Kingdom,K02000001,2021/8/3,30470,6102503,30070,6062418
552,288,overview,United Kingdom,K02000001,2021/8/4,32338,6134841,31891,6094309
553,287,overview,United Kingdom,K02000001,2021/8/5,31660,6166501,31248,6125557
554,286,overview,United Kingdom,K02000001,2021/8/6,28059,6194560,27669,6153226
555,285,overview,United Kingdom,K02000001,2021/8/7,22567,6217127,22269,6175495
556,284,overview,United Kingdom,K02000001,2021/8/8,22886,6240013,22608,6198103
557,283,overview,United Kingdom,K02000001,2021/8/9,32158,6272171,31689,6229792
558,282,overview,United Kingdom,K02000001,2021/8/10,31516,6303687,31065,6260857
559,281,overview,United Kingdom,K02000001,2021/8/11,33347,6337034,32932,6293789
560,280,overview,United Kingdom,K02000001,2021/8/12,31721,6368755,31280,6325069
561,279,overview,United Kingdom,K02000001,2021/8/13,28970,6397725,28612,6353681
562,278,overview,United Kingdom,K02000001,2021/8/14,25057,6422782,24784,6378465
563,277,overview,United Kingdom,K02000001,2021/8/15,25324,6448106,25031,6403496
564,276,overview,United Kingdom,K02000001,2021/8/16,36900,6485006,36399,6439895
565,275,overview,United Kingdom,K02000001,2021/8/17,37914,6522920,37347,6477242
566,274,overview,United Kingdom,K02000001,2021/8/18,38737,6561657,38204,6515446
567,273,overview,United Kingdom,K02000001,2021/8/19,36484,6598141,35985,6551431
568,272,overview,United Kingdom,K02000001,2021/8/20,32223,6630364,31813,6583244
569,271,overview,United Kingdom,K02000001,2021/8/21,28516,6658880,28195,6611439
570,270,overview,United Kingdom,K02000001,2021/8/22,28731,6687611,28422,6639861
571,269,overview,United Kingdom,K02000001,2021/8/23,39709,6727320,39218,6679079
572,268,overview,United Kingdom,K02000001,2021/8/24,37676,6764996,37171,6716250
573,267,overview,United Kingdom,K02000001,2021/8/25,38771,6803767,38288,6754538
574,266,overview,United Kingdom,K02000001,2021/8/26,37609,6841376,37113,6791651
575,265,overview,United Kingdom,K02000001,2021/8/27,33736,6875112,33326,6824977
576,264,overview,United Kingdom,K02000001,2021/8/28,27599,6902711,27291,6852268
577,263,overview,United Kingdom,K02000001,2021/8/29,26133,6928844,25813,6878081
578,262,overview,United Kingdom,K02000001,2021/8/30,34757,6963601,34304,6912385
579,261,overview,United Kingdom,K02000001,2021/8/31,45210,7008811,44609,6956994
580,260,overview,United Kingdom,K02000001,2021/9/1,43516,7052327,42981,6999975
581,259,overview,United Kingdom,K02000001,2021/9/2,42314,7094641,41757,7041732
582,258,overview,United Kingdom,K02000001,2021/9/3,38629,7133270,38168,7079900
583,257,overview,United Kingdom,K02000001,2021/9/4,31806,7165076,31438,7111338
584,256,overview,United Kingdom,K02000001,2021/9/5,31798,7196874,31417,7142755
585,255,overview,United Kingdom,K02000001,2021/9/6,44915,7241789,44332,7187087
586,254,overview,United Kingdom,K02000001,2021/9/7,38609,7280398,38126,7225213
587,253,overview,United Kingdom,K02000001,2021/9/8,35840,7316238,35338,7260551
588,252,overview,United Kingdom,K02000001,2021/9/9,33964,7350202,33544,7294095
589,251,overview,United Kingdom,K02000001,2021/9/10,29175,7379377,28803,7322898
590,250,overview,United Kingdom,K02000001,2021/9/11,23531,7402908,23247,7346145
591,249,overview,United Kingdom,K02000001,2021/9/12,24054,7426962,23761,7369906
592,248,overview,United Kingdom,K02000001,2021/9/13,34653,7461615,34225,7404131
593,247,overview,United Kingdom,K02000001,2021/9/14,31419,7493034,31025,7435156
594,246,overview,United Kingdom,K02000001,2021/9/15,30379,7523413,30026,7465182
595,245,overview,United Kingdom,K02000001,2021/9/16,29547,7552960,29195,7494377
596,244,overview,United Kingdom,K02000001,2021/9/17,29464,7582424,29122,7523499
597,243,overview,United Kingdom,K02000001,2021/9/18,26639,7609063,26344,7549843
598,242,overview,United Kingdom,K02000001,2021/9/19,31084,7640147,30711,7580554
599,241,overview,United Kingdom,K02000001,2021/9/20,40757,7680904,40253,7620807
600,240,overview,United Kingdom,K02000001,2021/9/21,38836,7719740,38382,7659189
601,239,overview,United Kingdom,K02000001,2021/9/22,36749,7756489,36299,7695488
602,238,overview,United Kingdom,K02000001,2021/9/23,35838,7792327,35342,7730830
603,237,overview,United Kingdom,K02000001,2021/9/24,32096,7824423,31705,7762535
604,236,overview,United Kingdom,K02000001,2021/9/25,28560,7852983,28235,7790770
605,235,overview,United Kingdom,K02000001,2021/9/26,32064,7885047,31670,7822440
606,234,overview,United Kingdom,K02000001,2021/9/27,41580,7926627,41082,7863522
607,233,overview,United Kingdom,K02000001,2021/9/28,36541,7963168,36100,7899622
608,232,overview,United Kingdom,K02000001,2021/9/29,34819,7997987,34424,7934046
609,231,overview,United Kingdom,K02000001,2021/9/30,32598,8030585,32222,7966268
610,230,overview,United Kingdom,K02000001,2021/10/1,29052,8059637,28743,7995011
611,229,overview,United Kingdom,K02000001,2021/10/2,26309,8085946,26044,8021055
612,228,overview,United Kingdom,K02000001,2021/10/3,32053,8117999,31715,8052770
613,227,overview,United Kingdom,K02000001,2021/10/4,43727,8161726,43258,8096028
614,226,overview,United Kingdom,K02000001,2021/10/5,39266,8200992,38798,8134826
615,225,overview,United Kingdom,K02000001,2021/10/6,39256,8240248,38819,8173645
616,224,overview,United Kingdom,K02000001,2021/10/7,38463,8278711,38021,8211666
617,223,overview,United Kingdom,K02000001,2021/10/8,35600,8314311,35181,8246847
618,222,overview,United Kingdom,K02000001,2021/10/9,32297,8346608,31936,8278783
619,221,overview,United Kingdom,K02000001,2021/10/10,36408,8383016,36017,8314800
620,220,overview,United Kingdom,K02000001,2021/10/11,50288,8433304,49746,8364546
621,219,overview,United Kingdom,K02000001,2021/10/12,48305,8481609,47712,8412258
622,218,overview,United Kingdom,K02000001,2021/10/13,47772,8529381,47237,8459495
623,217,overview,United Kingdom,K02000001,2021/10/14,46417,8575798,45871,8505366
624,216,overview,United Kingdom,K02000001,2021/10/15,43553,8619351,43089,8548455
625,215,overview,United Kingdom,K02000001,2021/10/16,37877,8657228,37482,8585937
626,214,overview,United Kingdom,K02000001,2021/10/17,43747,8700975,43302,8629239
627,213,overview,United Kingdom,K02000001,2021/10/18,57735,8758710,57031,8686270
628,212,overview,United Kingdom,K02000001,2021/10/19,52514,8811224,51894,8738164
629,211,overview,United Kingdom,K02000001,2021/10/20,51658,8862882,51099,8789263
630,210,overview,United Kingdom,K02000001,2021/10/21,45192,8908074,44651,8833914
631,209,overview,United Kingdom,K02000001,2021/10/22,40661,8948735,40179,8874093
632,208,overview,United Kingdom,K02000001,2021/10/23,35098,8983833,34715,8908808
633,207,overview,United Kingdom,K02000001,2021/10/24,35760,9019593,35362,8944170
634,206,overview,United Kingdom,K02000001,2021/10/25,47456,9067049,46874,8991044
635,205,overview,United Kingdom,K02000001,2021/10/26,42121,9109170,41627,9032671
636,204,overview,United Kingdom,K02000001,2021/10/27,43040,9152210,42534,9075205
637,203,overview,United Kingdom,K02000001,2021/10/28,41379,9193589,40863,9116068
638,202,overview,United Kingdom,K02000001,2021/10/29,40251,9233840,39750,9155818
639,201,overview,United Kingdom,K02000001,2021/10/30,33567,9267407,33219,9189037
640,200,overview,United Kingdom,K02000001,2021/10/31,34800,9302207,34352,9223389
641,199,overview,United Kingdom,K02000001,2021/11/1,45104,9347311,44479,9267868
642,198,overview,United Kingdom,K02000001,2021/11/2,38014,9385325,37524,9305392
643,197,overview,United Kingdom,K02000001,2021/11/3,35982,9421307,35523,9340915
644,196,overview,United Kingdom,K02000001,2021/11/4,33656,9454963,33234,9374149
645,195,overview,United Kingdom,K02000001,2021/11/5,30314,9485277,29885,9404034
646,194,overview,United Kingdom,K02000001,2021/11/6,27435,9512712,27088,9431122
647,193,overview,United Kingdom,K02000001,2021/11/7,30585,9543297,30195,9461317
648,192,overview,United Kingdom,K02000001,2021/11/8,44125,9587422,43503,9504820
649,191,overview,United Kingdom,K02000001,2021/11/9,42244,9629666,41673,9546493
650,190,overview,United Kingdom,K02000001,2021/11/10,42940,9672606,42380,9588873
651,189,overview,United Kingdom,K02000001,2021/11/11,40989,9713595,40415,9629288
652,188,overview,United Kingdom,K02000001,2021/11/12,37753,9751348,37264,9666552
653,187,overview,United Kingdom,K02000001,2021/11/13,32883,9784231,32512,9699064
654,186,overview,United Kingdom,K02000001,2021/11/14,35514,9819745,35102,9734166
655,185,overview,United Kingdom,K02000001,2021/11/15,50946,9870691,50233,9784399
656,184,overview,United Kingdom,K02000001,2021/11/16,46424,9917115,45765,9830164
657,183,overview,United Kingdom,K02000001,2021/11/17,45889,9963004,45295,9875459
658,182,overview,United Kingdom,K02000001,2021/11/18,44056,10007060,43458,9918917
659,181,overview,United Kingdom,K02000001,2021/11/19,39596,10046656,39123,9958040
660,180,overview,United Kingdom,K02000001,2021/11/20,35331,10081987,34887,9992927
661,179,overview,United Kingdom,K02000001,2021/11/21,37245,10119232,36787,10029714
662,178,overview,United Kingdom,K02000001,2021/11/22,50725,10169957,50058,10079772
663,177,overview,United Kingdom,K02000001,2021/11/23,48191,10218148,47548,10127320
664,176,overview,United Kingdom,K02000001,2021/11/24,46763,10264911,46093,10173413
665,175,overview,United Kingdom,K02000001,2021/11/25,43415,10308326,42794,10216207
666,174,overview,United Kingdom,K02000001,2021/11/26,39327,10347653,38800,10255007
667,173,overview,United Kingdom,K02000001,2021/11/27,33294,10380947,32872,10287879
668,172,overview,United Kingdom,K02000001,2021/11/28,39693,10420640,39181,10327060
669,171,overview,United Kingdom,K02000001,2021/11/29,56289,10476929,55432,10382492
670,170,overview,United Kingdom,K02000001,2021/11/30,55688,10532617,54890,10437382
671,169,overview,United Kingdom,K02000001,2021/12/1,54816,10587433,54011,10491393
672,168,overview,United Kingdom,K02000001,2021/12/2,50319,10637752,49565,10540958
673,167,overview,United Kingdom,K02000001,2021/12/3,45663,10683415,44981,10585939
674,166,overview,United Kingdom,K02000001,2021/12/4,38782,10722197,38139,10624078
675,165,overview,United Kingdom,K02000001,2021/12/5,41018,10763215,40340,10664418
676,164,overview,United Kingdom,K02000001,2021/12/6,59665,10822880,58394,10722812
677,163,overview,United Kingdom,K02000001,2021/12/7,56234,10879114,54808,10777620
678,162,overview,United Kingdom,K02000001,2021/12/8,58807,10937921,57170,10834790
679,161,overview,United Kingdom,K02000001,2021/12/9,56984,10994905,55232,10890022
680,160,overview,United Kingdom,K02000001,2021/12/10,52479,11047384,50836,10940858
681,159,overview,United Kingdom,K02000001,2021/12/11,48594,11095978,47011,10987869
682,158,overview,United Kingdom,K02000001,2021/12/12,53151,11149129,51116,11038985
683,157,overview,United Kingdom,K02000001,2021/12/13,87163,11236292,82819,11121804
684,156,overview,United Kingdom,K02000001,2021/12/14,102758,11339050,96306,11218110
685,155,overview,United Kingdom,K02000001,2021/12/15,112685,11451735,105023,11323133
686,154,overview,United Kingdom,K02000001,2021/12/16,106041,11557776,98505,11421638
687,153,overview,United Kingdom,K02000001,2021/12/17,95874,11653650,89014,11510652
688,152,overview,United Kingdom,K02000001,2021/12/18,88880,11742530,82658,11593310
689,151,overview,United Kingdom,K02000001,2021/12/19,89129,11831659,82729,11676039
690,150,overview,United Kingdom,K02000001,2021/12/20,133945,11965604,123717,11799756
691,149,overview,United Kingdom,K02000001,2021/12/21,150281,12115885,138164,11937920
692,148,overview,United Kingdom,K02000001,2021/12/22,161542,12277427,147967,12085887
693,147,overview,United Kingdom,K02000001,2021/12/23,160629,12438056,147063,12232950
694,146,overview,United Kingdom,K02000001,2021/12/24,137266,12575322,126192,12359142
695,145,overview,United Kingdom,K02000001,2021/12/25,70361,12645683,65268,12424410
696,144,overview,United Kingdom,K02000001,2021/12/26,116274,12761957,107296,12531706
697,143,overview,United Kingdom,K02000001,2021/12/27,194993,12956950,178941,12710647
698,142,overview,United Kingdom,K02000001,2021/12/28,212456,13169406,194084,12904731
699,141,overview,United Kingdom,K02000001,2021/12/29,272777,13442183,248850,13153581
700,140,overview,United Kingdom,K02000001,2021/12/30,236574,13678757,214654,13368235
701,139,overview,United Kingdom,K02000001,2021/12/31,188563,13867320,171324,13539559
702,138,overview,United Kingdom,K02000001,2022/1/1,118211,13985531,107609,13647168
703,137,overview,United Kingdom,K02000001,2022/1/2,181072,14166603,163344,13810512
704,136,overview,United Kingdom,K02000001,2022/1/3,229883,14396486,206339,14016851
705,135,overview,United Kingdom,K02000001,2022/1/4,275636,14672122,247288,14264139
706,134,overview,United Kingdom,K02000001,2022/1/5,222145,14894267,199347,14463486
707,133,overview,United Kingdom,K02000001,2022/1/6,172975,15067242,154994,14618480
708,132,overview,United Kingdom,K02000001,2022/1/7,120281,15187523,108574,14727054
709,131,overview,United Kingdom,K02000001,2022/1/8,93612,15281135,84986,14812040
710,130,overview,United Kingdom,K02000001,2022/1/9,95769,15376904,86968,14899008
711,129,overview,United Kingdom,K02000001,2022/1/10,132820,15509724,120297,15019305
712,128,overview,United Kingdom,K02000001,2022/1/11,115229,15624953,104436,15123741
713,127,overview,United Kingdom,K02000001,2022/1/12,103210,15728163,93476,15217217
714,126,overview,United Kingdom,K02000001,2022/1/13,96403,15824566,87543,15304760
715,125,overview,United Kingdom,K02000001,2022/1/14,86322,15910888,78642,15383402
716,124,overview,United Kingdom,K02000001,2022/1/15,77933,15988821,71296,15454698
717,123,overview,United Kingdom,K02000001,2022/1/16,98071,16086892,89122,15543820
718,122,overview,United Kingdom,K02000001,2022/1/17,131502,16218394,118969,15662789
719,121,overview,United Kingdom,K02000001,2022/1/18,118737,16337131,107495,15770284
720,120,overview,United Kingdom,K02000001,2022/1/19,111747,16448878,101239,15871523
721,119,overview,United Kingdom,K02000001,2022/1/20,100313,16549191,91033,15962556
722,118,overview,United Kingdom,K02000001,2022/1/21,91563,16640754,83157,16045713
723,117,overview,United Kingdom,K02000001,2022/1/22,81716,16722470,74536,16120249
724,116,overview,United Kingdom,K02000001,2022/1/23,102327,16824797,92584,16212833
725,115,overview,United Kingdom,K02000001,2022/1/24,127330,16952127,114686,16327519
726,114,overview,United Kingdom,K02000001,2022/1/25,113162,17065289,101940,16429459
727,113,overview,United Kingdom,K02000001,2022/1/26,108652,17173941,97927,16527386
728,112,overview,United Kingdom,K02000001,2022/1/27,96182,17270123,86815,16614201
729,111,overview,United Kingdom,K02000001,2022/1/28,84018,17354141,76109,16690310
730,110,overview,United Kingdom,K02000001,2022/1/29,73501,17427642,66851,16757161
731,109,overview,United Kingdom,K02000001,2022/1/30,87555,17515197,78991,16836152
732,108,overview,United Kingdom,K02000001,2022/1/31,104922,17620119,94187,16930339
733,107,overview,United Kingdom,K02000001,2022/2/1,93762,17713881,84206,17014545
734,106,overview,United Kingdom,K02000001,2022/2/2,88401,17802282,79725,17094270
735,105,overview,United Kingdom,K02000001,2022/2/3,76618,17878900,69084,17163354
736,104,overview,United Kingdom,K02000001,2022/2/4,63188,17942088,57312,17220666
737,103,overview,United Kingdom,K02000001,2022/2/5,52301,17994389,47537,17268203
738,102,overview,United Kingdom,K02000001,2022/2/6,60536,18054925,54622,17322825
739,101,overview,United Kingdom,K02000001,2022/2/7,76461,18131386,68661,17391486
740,100,overview,United Kingdom,K02000001,2022/2/8,69626,18201012,62766,17454252
741,99,overview,United Kingdom,K02000001,2022/2/9,64305,18265317,57952,17512204
742,98,overview,United Kingdom,K02000001,2022/2/10,52280,18317597,47140,17559344
743,97,overview,United Kingdom,K02000001,2022/2/11,44557,18362154,40498,17599842
744,96,overview,United Kingdom,K02000001,2022/2/12,37429,18399583,34165,17634007
745,95,overview,United Kingdom,K02000001,2022/2/13,41737,18441320,37944,17671951
746,94,overview,United Kingdom,K02000001,2022/2/14,54687,18496007,49489,17721440
747,93,overview,United Kingdom,K02000001,2022/2/15,52494,18548501,47524,17768964
748,92,overview,United Kingdom,K02000001,2022/2/16,51547,18600048,46704,17815668
749,91,overview,United Kingdom,K02000001,2022/2/17,44691,18644739,40419,17856087
750,90,overview,United Kingdom,K02000001,2022/2/18,33236,18677975,30221,17886308
751,89,overview,United Kingdom,K02000001,2022/2/19,34646,18712621,31610,17917918
752,88,overview,United Kingdom,K02000001,2022/2/20,37684,18750305,34312,17952230
753,87,overview,United Kingdom,K02000001,2022/2/21,45119,18795424,40829,17993059
754,86,overview,United Kingdom,K02000001,2022/2/22,39146,18834570,35385,18028444
755,85,overview,United Kingdom,K02000001,2022/2/23,36464,18871034,33025,18061469
756,84,overview,United Kingdom,K02000001,2022/2/24,30618,18901652,27729,18089198
757,83,overview,United Kingdom,K02000001,2022/2/25,27840,18929492,25292,18114490
758,82,overview,United Kingdom,K02000001,2022/2/26,25093,18954585,22957,18137447
759,81,overview,United Kingdom,K02000001,2022/2/27,31361,18985946,28534,18165981
760,80,overview,United Kingdom,K02000001,2022/2/28,44639,19030585,40326,18206307
761,79,overview,United Kingdom,K02000001,2022/3/1,44779,19075364,40532,18246839
762,78,overview,United Kingdom,K02000001,2022/3/2,46167,19121531,41609,18288448
763,77,overview,United Kingdom,K02000001,2022/3/3,43751,19165282,39522,18327970
764,76,overview,United Kingdom,K02000001,2022/3/4,41398,19206680,37411,18365381
765,75,overview,United Kingdom,K02000001,2022/3/5,38754,19245434,35194,18400575
766,74,overview,United Kingdom,K02000001,2022/3/6,49022,19294456,44193,18444768
767,73,overview,United Kingdom,K02000001,2022/3/7,68546,19363002,61155,18505923
768,72,overview,United Kingdom,K02000001,2022/3/8,70124,19433126,62969,18568892
769,71,overview,United Kingdom,K02000001,2022/3/9,73524,19506650,66029,18634921
770,70,overview,United Kingdom,K02000001,2022/3/10,70512,19577162,63271,18698192
771,69,overview,United Kingdom,K02000001,2022/3/11,67050,19644212,60387,18758579
772,68,overview,United Kingdom,K02000001,2022/3/12,62076,19706288,55919,18814498
773,67,overview,United Kingdom,K02000001,2022/3/13,75740,19782028,67833,18882331
774,66,overview,United Kingdom,K02000001,2022/3/14,99864,19881892,88978,18971309
775,65,overview,United Kingdom,K02000001,2022/3/15,93686,19975578,83666,19054975
776,64,overview,United Kingdom,K02000001,2022/3/16,91778,20067356,81893,19136868
777,63,overview,United Kingdom,K02000001,2022/3/17,82860,20150216,73931,19210799
778,62,overview,United Kingdom,K02000001,2022/3/18,75301,20225517,67410,19278209
779,61,overview,United Kingdom,K02000001,2022/3/19,67427,20292944,60609,19338818
780,60,overview,United Kingdom,K02000001,2022/3/20,81064,20374008,72197,19411015
781,59,overview,United Kingdom,K02000001,2022/3/21,109324,20483332,96431,19507446
782,58,overview,United Kingdom,K02000001,2022/3/22,99098,20582430,87750,19595196
783,57,overview,United Kingdom,K02000001,2022/3/23,94176,20676606,83439,19678635
784,56,overview,United Kingdom,K02000001,2022/3/24,82911,20759517,73633,19752268
785,55,overview,United Kingdom,K02000001,2022/3/25,72446,20831963,64436,19816704
786,54,overview,United Kingdom,K02000001,2022/3/26,61460,20893423,54968,19871672
787,53,overview,United Kingdom,K02000001,2022/3/27,68326,20961749,60591,19932263
788,52,overview,United Kingdom,K02000001,2022/3/28,92903,21054652,81530,20013793
789,51,overview,United Kingdom,K02000001,2022/3/29,80144,21134796,70630,20084423
790,50,overview,United Kingdom,K02000001,2022/3/30,73670,21208466,64997,20149420
791,49,overview,United Kingdom,K02000001,2022/3/31,54796,21263262,48599,20198019
792,48,overview,United Kingdom,K02000001,2022/4/1,47489,21310751,42284,20240303
793,47,overview,United Kingdom,K02000001,2022/4/2,37600,21348351,33603,20273906
794,46,overview,United Kingdom,K02000001,2022/4/3,42192,21390543,37606,20311512
795,45,overview,United Kingdom,K02000001,2022/4/4,53762,21444305,47408,20358920
796,44,overview,United Kingdom,K02000001,2022/4/5,49077,21493382,43454,20402374
797,43,overview,United Kingdom,K02000001,2022/4/6,44731,21538113,39515,20441889
798,42,overview,United Kingdom,K02000001,2022/4/7,38688,21576801,34143,20476032
799,41,overview,United Kingdom,K02000001,2022/4/8,32975,21609776,29244,20505276
800,40,overview,United Kingdom,K02000001,2022/4/9,27878,21637654,24834,20530110
801,39,overview,United Kingdom,K02000001,2022/4/10,30936,21668590,27571,20557681
802,38,overview,United Kingdom,K02000001,2022/4/11,37360,21705950,32861,20590542
803,37,overview,United Kingdom,K02000001,2022/4/12,33758,21739708,29806,20620348
804,36,overview,United Kingdom,K02000001,2022/4/13,31667,21771375,28106,20648454
805,35,overview,United Kingdom,K02000001,2022/4/14,26639,21798014,23604,20672058
806,34,overview,United Kingdom,K02000001,2022/4/15,21608,21819622,19213,20691271
807,33,overview,United Kingdom,K02000001,2022/4/16,19917,21839539,17790,20709061
808,32,overview,United Kingdom,K02000001,2022/4/17,20142,21859681,17843,20726904
809,31,overview,United Kingdom,K02000001,2022/4/18,25181,21884862,21928,20748832
810,30,overview,United Kingdom,K02000001,2022/4/19,25755,21910617,22223,20771055
811,29,overview,United Kingdom,K02000001,2022/4/20,21433,21932050,18656,20789711
812,28,overview,United Kingdom,K02000001,2022/4/21,18452,21950502,16010,20805721
813,27,overview,United Kingdom,K02000001,2022/4/22,15693,21966195,13589,20819310
814,26,overview,United Kingdom,K02000001,2022/4/23,13205,21979400,11608,20830918
815,25,overview,United Kingdom,K02000001,2022/4/24,14718,21994118,12703,20843621
816,24,overview,United Kingdom,K02000001,2022/4/25,17113,22011231,14444,20858065
817,23,overview,United Kingdom,K02000001,2022/4/26,14558,22025789,12461,20870526
818,22,overview,United Kingdom,K02000001,2022/4/27,13039,22038828,11134,20881660
819,21,overview,United Kingdom,K02000001,2022/4/28,11592,22050420,9897,20891557
820,20,overview,United Kingdom,K02000001,2022/4/29,9997,22060417,8616,20900173
821,19,overview,United Kingdom,K02000001,2022/4/30,8356,22068773,7240,20907413
822,18,overview,United Kingdom,K02000001,2022/5/1,9025,22077798,7770,20915183
823,17,overview,United Kingdom,K02000001,2022/5/2,11884,22089682,10054,20925237
824,16,overview,United Kingdom,K02000001,2022/5/3,13288,22102970,11138,20936375
825,15,overview,United Kingdom,K02000001,2022/5/4,11660,22114630,9842,20946217
826,14,overview,United Kingdom,K02000001,2022/5/5,10199,22124829,8586,20954803
827,13,overview,United Kingdom,K02000001,2022/5/6,8926,22133755,7575,20962378
828,12,overview,United Kingdom,K02000001,2022/5/7,7516,22141271,6436,20968814
829,11,overview,United Kingdom,K02000001,2022/5/8,9047,22150318,7589,20976403
830,10,overview,United Kingdom,K02000001,2022/5/9,10679,22160997,8886,20985289
831,9,overview,United Kingdom,K02000001,2022/5/10,9712,22170709,8106,20993395
832,8,overview,United Kingdom,K02000001,2022/5/11,8699,22179408,7282,21000677
833,7,overview,United Kingdom,K02000001,2022/5/12,7614,22187022,6411,21007088
834,6,overview,United Kingdom,K02000001,2022/5/13,6893,22193915,5850,21012938
835,5,overview,United Kingdom,K02000001,2022/5/14,6103,22200018,5144,21018082
836,4,overview,United Kingdom,K02000001,2022/5/15,7943,22207961,6659,21024741
837,3,overview,United Kingdom,K02000001,2022/5/16,9393,22217354,7721,21032462
838,2,overview,United Kingdom,K02000001,2022/5/17,8262,22225616,6879,21039341
839,1,overview,United Kingdom,K02000001,2022/5/18,7624,22233240,6358,21045699
840,0,overview,United Kingdom,K02000001,2022/5/19,6802,22240042,5605,21051304
